Grand Theft Auto V - Rockstar Games
The Last of Us - Naughty Dog
Red Dead Redemption 2 - Rockstar Games
The Witcher 3: Wild Hunt - CD Projekt Red
Cyberpunk 2077 - CD Projekt Red
God of War - Santa Monica Studio
Horizon Zero Dawn - Guerrilla Games
Assassin's Creed Odyssey - Ubisoft
Assassin's Creed Valhalla - Ubisoft
The Elder Scrolls V: Skyrim - Bethesda Game Studios
Bioshock Infinite - Irrational Games
Uncharted 4: A Thief's End - Naughty Dog
Mass Effect 2 - BioWare
Mass Effect 3 - BioWare
Dragon Age: Inquisition - BioWare
Bloodborne - FromSoftware
Dark Souls III - FromSoftware
Sekiro: Shadows Die Twice - FromSoftware
Death Stranding - Kojima Productions
Control - Remedy Entertainment
Disco Elysium - ZA/UM
Fallout 4 - Bethesda Game Studios
Fallout New Vegas - Obsidian Entertainment
Tales from the Borderlands - Telltale Games
Life is Strange - Dontnod Entertainment
Life is Strange: Before the Storm - Deck Nine
Detroit: Become Human - Quantic Dream
Heavy Rain - Quantic Dream
Until Dawn - Supermassive Games
The Walking Dead: The Telltale Series - Telltale Games
The Wolf Among Us - Telltale Games
Firewatch - Campo Santo
Oxenfree - Night School Studio
Alan Wake - Remedy Entertainment
Max Payne 3 - Rockstar Games
Hitman 3 - IO Interactive
Watch Dogs 2 - Ubisoft
Watch Dogs: Legion - Ubisoft
Far Cry 5 - Ubisoft
Far Cry 3 - Ubisoft
Metro Exodus - 4A Games
Metro Last Light - 4A Games
Shadow of Mordor - Monolith Productions
Shadow of War - Monolith Productions
Prey (2017) - Arkane Studios
Assassin's Creed Origins - Ubisoft
Divinity: Original Sin 2 - Larian Studios
The Outer Worlds - Obsidian Entertainment
Outer Wilds - Mobius Digital
Hellblade: Senua's Sacrifice - Ninja Theory
Subnautica - Unknown Worlds Entertainment
Hades - Supergiant Games
A Plague Tale: Innocence - Asobo Studio
Remnant: From the Ashes - Gunfire Games
GreedFall - Spiders
The Banner Saga - Stoic Studio
Soma - Frictional Games
Layers of Fear - Bloober Team
Control - Remedy Entertainment
Resident Evil 2 (2019) - Capcom
Resident Evil Village - Capcom
Yakuza 0 - Ryu Ga Gotoku Studio
Yakuza: Like a Dragon - Ryu Ga Gotoku Studio
Judgment - Ryu Ga Gotoku Studio
Nier: Automata - PlatinumGames
Tales of Berseria - Bandai Namco Entertainment
The Legend of Heroes: Trails of Cold Steel IV - Nihon Falcom
Dragonâ€™s Dogma - Capcom
Vampyr - Dontnod Entertainment
State of Decay 2 - Undead Labs
Far Cry Primal - Ubisoft
Sunset Overdrive - Insomniac Games
Quantum Break - Remedy Entertainment
Dead Space - EA Redwood Shores (later Visceral Games)
The Evil Within - Tango Gameworks
Dishonored - Arkane Studios
Dishonored 2 - Arkane Studios
The Last Guardian - Team Ico
Journey - Thatgamecompany
The Walking Dead: Michonne - Telltale Games
Star Wars Jedi: Fallen Order - Respawn Entertainment
Metro 2033 - 4A Games
The Surge - Deck13 Interactive
The Surge 2 - Deck13 Interactive
Syndicate - Starbreeze Studios
Fallout 76 - Bethesda Game Studios
Vampire: The Masquerade - Bloodlines 2 - Hardsuit Labs
Prey (2006) - Human Head Studios
Heaven's Vault - inkle
The Banner Saga 2 - Stoic Studio
The Banner Saga 3 - Stoic Studio
Pathologic Classic HD - Ice-Pick Lodge
The Talos Principle - Croteam
Spec Ops: The Line - Yager Development
The Last of Us Part II - Naughty Dog
Control: Ultimate Edition - Remedy Entertainment
The Outer Worlds - Obsidian Entertainment
Ghost of Tsushima - Sucker Punch Productions
Little Nightmares - Tarsier Studios
Little Nightmares II - Tarsier Studios