Strobe – Deadmau5
Levels – Avicii
Titanium – David Guetta ft. Sia
Wake Me Up – Avicii
Animals – Martin Garrix
Scary Monsters and Nice Sprites – Skrillex
Get Lucky – Daft Punk ft. Pharrell Williams
One More Time – Daft Punk
Lean On – Major Lazer & DJ Snake ft. MØ
Starboy – The Weeknd ft. Daft Punk
Go! – The Chemical Brothers
Adagio for Strings – Tiësto
I Remember – Deadmau5 & Kaskade
Clarity – Zedd ft. Foxes
Bad Guy – Billie Eilish
Don't You Worry Child – Swedish House Mafia ft. John Martin
Summertime Sadness (Remix) – Lana Del Rey ft. Cedric Gervais
Power – Kanye West (Produced by Daft Punk)
Heartless – The Weeknd
I Could Be the One – Avicii vs. Nicky Romero
Spaceman – Hardwell
Take Over Control – Afrojack ft. Eva Simons
Calling (Lose My Mind) – Sebastian Ingrosso, Alesso ft. Ryan Tedder
Tremor – Dimitri Vegas & Like Mike, Martin Garrix
Miami – Eric Prydz
Turn Down for What – DJ Snake & Lil Jon
Promises – Calvin Harris
Wake Me Up (Acoustic) – Avicii
Animals – Martin Garrix
Helium – Sasha Alex S
Blue Monday – New Order
HyperParadise (Flume Remix) – Hermitude
Gold Dust – DJ Fresh
The Veldt – Deadmau5 ft. Chris James
Be Right There – The Black Eyed Peas
Go! – The Chemical Brothers
Moth to a Flame – Swedish House Mafia, The Weeknd
Lose Yourself to Dance – Daft Punk ft. Pharrell Williams
Right Here, Right Now – Fatboy Slim
Da Funk – Daft Punk
Midnight City – M83
Paper Planes (Diplo Remix) – M.I.A.
This Girl – Kungs vs Cookin' on 3 Burners
I Love It – Icona Pop ft. Charli XCX
Dance Monkey – Tones and I
Midnight City – M83
Pump Up the Jam – Technotronic
Around the World – Daft Punk
Animals – Martin Garrix
Satisfaction – Benny Benassi
Lose Control – Meduza, Becky Hill, Goodboys
Alone – Marshmello
Higher Love – Kygo & Whitney Houston
Stolen Dance – Milky Chance
Ride It – Regard
All Night – Steve Aoki & Lauren Jauregui
Go! – The Chemical Brothers
Sandstorm – Darude
Sweet Disposition (The C90s Remix) – The Temper Trap
Don't Let Me Down – The Chainsmokers ft. Daya
Scared to Be Lonely – Martin Garrix & Dua Lipa
Feel So Close – Calvin Harris
Titanium – David Guetta ft. Sia
For An Angel – Paul van Dyk
Dreams – Fleetwood Mac (Psychemagik Remix)
Stargazing – Kygo
In The Name of Love – Martin Garrix & Bebe Rexha
Headlights – Robin Schulz ft. Ilsey
Shivers – Ed Sheeran
Fast Car – Jonas Blue ft. Dakota
Go! – The Chemical Brothers
Where Are Ü Now – Jack Ü ft. Justin Bieber
Turn Down for What – DJ Snake & Lil Jon
All Of Me (Tiësto Remix) – John Legend
Sweet Life – Kaytranada
You Don’t Know Me – Jax Jones ft. Raye
Bury It – CHVRCHES ft. Hayley Williams
One Kiss – Calvin Harris & Dua Lipa
Ritual – Tiësto, Jonas Blue, Rita Ora
Memories – David Guetta ft. Kid Cudi
The Nights – Avicii
You & Me – Marc E. Bassy (Bebe Rexha Remix)
My Feelings for You – Edx
What About Us – Pink (Dave Aude Remix)
Magic – Coldplay
Heaven – Avicii
No Tears Left to Cry (Boehm Remix) – Ariana Grande
Can't Hold Us – Macklemore & Ryan Lewis ft. Ray Dalton
Lonely – Joel Corry
I Like Me Better (Remix) – Lauv
Colors – Martin Solveig
Good As Hell – Lizzo
You Should Know – Liam Payne
You Know You Like It – DJ Snake & AlunaGeorge
Memories – David Guetta ft. Kid Cudi
Music Sounds Better With You – Stardust
Desire – Years & Years
Dancing with a Stranger – Sam Smith & Normani
Replay – SHY Martin
In My Mind – Ivan Gough & Feenixpawl ft. Georgi Kay