Juicy – The Notorious B.I.G.
Nuthin' but a 'G' Thang – Dr. Dre ft. Snoop Dogg
The Message – Grandmaster Flash and the Furious Five
Lose Yourself – Eminem
C.R.E.A.M. – Wu-Tang Clan
Fight the Power – Public Enemy
Stan – Eminem ft. Dido
California Love – 2Pac ft. Dr. Dre
HUMBLE. – Kendrick Lamar
Empire State of Mind – Jay-Z ft. Alicia Keys
In Da Club – 50 Cent
Rapper's Delight – The Sugarhill Gang
N.Y. State of Mind – Nas
Mo Money Mo Problems – The Notorious B.I.G. ft. Puff Daddy & Mase
Big Pimpin' – Jay-Z ft. UGK
Hotline Bling – Drake
Gin and Juice – Snoop Dogg
All Falls Down – Kanye West ft. Syleena Johnson
Get Ur Freak On – Missy Elliott
Jesus Walks – Kanye West
I Like It – Cardi B ft. Bad Bunny & J Balvin
Ruff Ryders' Anthem – DMX
The Breaks – Kurtis Blow
Passin' Me By – The Pharcyde
Pusherman – Curtis Mayfield
Runaway – Kanye West ft. Pusha T
Money Trees – Kendrick Lamar ft. Jay Rock
Lose Control – Missy Elliott ft. Ciara & Fatman Scoop
Crossroads – Bone Thugs-N-Harmony
Sicko Mode – Travis Scott
Cups – Anna Kendrick
HUMBLE. – Kendrick Lamar
One Dance – Drake ft. Wizkid & Kyla
Black and Yellow – Wiz Khalifa
The Way I Am – Eminem
I Get Around – 2Pac
N.Y. State of Mind – Nas
Crank That (Soulja Boy) – Soulja Boy Tell 'Em
Viva La Vida – Coldplay
A Milli – Lil Wayne
Best I Ever Had – Drake
Gold Digger – Kanye West ft. Jamie Foxx
Congratulations – Post Malone ft. Quavo
Bodak Yellow – Cardi B
Antidote – Travis Scott
HUMBLE. – Kendrick Lamar
No Role Modelz – J. Cole
Panda – Desiigner
Sicko Mode – Travis Scott
All Star – Smash Mouth
Jumpman – Drake & Future
Old Town Road – Lil Nas X ft. Billy Ray Cyrus
Trap Queen – Fetty Wap
Mask Off – Future
Hotline Bling – Drake
Pony – Ginuwine
6 Foot 7 Foot – Lil Wayne ft. Cory Gunz
The Next Episode – Dr. Dre ft. Snoop Dogg
Money Longer – Lil Uzi Vert
Bad and Boujee – Migos ft. Lil Uzi Vert
Suge – DaBaby
God's Plan – Drake
Goosebumps – Travis Scott ft. Kendrick Lamar
Look At Me Now – Chris Brown ft. Lil Wayne & Busta Rhymes
Thrift Shop – Macklemore & Ryan Lewis ft. Wanz
XO TOUR Llif3 – Lil Uzi Vert
Fk Wit Dre Day – Dr. Dre
Power – Kanye West
For What It's Worth – Snoop Dogg
No Problem – Chance the Rapper ft. 2 Chainz & Lil Wayne
Ain't No Half-Steppin' – Big Daddy Kane
Top Off – DJ Khaled ft. Jay-Z, Future & Beyoncé
Lemonade – Gucci Mane
Controlla – Drake
Slide – Calvin Harris ft. Frank Ocean & Migos
Heartless – Kanye West
I Love It – Kanye West & Lil Pump
U Don't Have to Call – Usher
Milly Rock – 2 Milly
Shook Ones Pt. II – Mobb Deep
Gonna Love Me – Teyana Taylor
WAP – Cardi B ft. Megan Thee Stallion
My Name Is – Eminem
Radioactive – Imagine Dragons
Rico – Rico Nasty
Trophies – Drake
Unforgettable – French Montana ft. Swae Lee
Famous – Kanye West
Lamborghini Mercy – Kanye West ft. Big Sean
Stay – Post Malone
Walk It Talk It – Migos ft. Drake
Roll in Peace – Kodak Black ft. XXXTentacion
Hustlin' – Rick Ross
The Way – Ariana Grande ft. Mac Miller
I Like It – Cardi B ft. Bad Bunny & J Balvin
Swang – Rae Sremmurd
Believer – Imagine Dragons
All the Stars – Kendrick Lamar & SZA
Talk – Khalid
Don't Let Me Down – The Chainsmokers ft. Daya