Despacito – Luis Fonsi ft. Daddy Yankee
Hips Don't Lie – Shakira ft. Wyclef Jean
Bailando – Enrique Iglesias ft. Sean Paul, Descemer Bueno, Gente de Zona
Vivir Mi Vida – Marc Anthony
La Bicicleta – Carlos Vives ft. Shakira
Dákiti – Bad Bunny & Jhay Cortez
Mi Gente – J Balvin & Willy William ft. Beyoncé
Taki Taki – DJ Snake ft. Selena Gomez, Ozuna, Cardi B
I Like It – Cardi B ft. Bad Bunny & J Balvin
Bésame Mucho – Consuelo Velázquez
Lento – Lauren Jauregui & Tainy
Bailar – Elvis Crespo
X (Equis) – Nicky Jam & J Balvin
Reggaeton Lento (Remix) – CNCO & Little Mix
El Perdón – Nicky Jam & Enrique Iglesias
Duele El Corazón – Enrique Iglesias ft. Wisin
El Anillo – Jennifer Lopez
Lo Malo – Aitana & Ana Guerra
Cásate Conmigo – Silvestre Dangond & Nicky Jam
Cielito Lindo – Mariachi Vargas de Tecalitlán
Súbeme La Radio – Enrique Iglesias ft. Descemer Bueno & Gente de Zona
Me Voy – Julieta Venegas
Te Boté (Remix) – Nio García, Bad Bunny, Ozuna, Anuel AA
Héroe – Enrique Iglesias
Chantaje – Shakira ft. Maluma
Picky – Joey Montana
Rumba – Anuel AA ft. Farruko
Que Tire Pa Lante – Daddy Yankee
Tequila – Dan + Shay
Colocao – Nicky Jam
No Me Acuerdo – Thalía ft. Natti Natasha
Ritmo (Bad Boys for Life) – Black Eyed Peas, J Balvin
Dile Que Tú Me Quieres – Ozuna
Pa' Ti – Jennifer Lopez & Maluma
Baila Baila Baila – Enrique Iglesias
Acaríñame – Los Ángeles Azules ft. Ximena Sariñana
Un Año – Sebastián Yatra ft. Reik
Vente Pa' Ca – Ricky Martin ft. Maluma
Amor Eterno – Rocío Dúrcal
Sin Pijama – Becky G & Natti Natasha
Dama G – Chino & Nacho ft. Yandel
Que Bonito – Manuel Turizo
Baila – Sean Paul ft. J Balvin
Ginza – J Balvin
Tú – Shakira
A quién le importa – Alaska y Dinarama
La Rompe Corazones – Daddy Yankee ft. Ozuna
Hasta Que Me Olvides – Luis Miguel
Eres Tú – Mocedades
Mientes – Camila
Bonita – Juanes & Sebastián Yatra
Vente Pa' Ca – Ricky Martin ft. Maluma
Tú Eres Mi Todo – Gente de Zona
Cuando Te Besé – Becky G
Reloj – Luis Miguel
Mi Persona Favorita – Río Roma
Baila Morena – Héctor & Tito ft. Daddy Yankee
Darte un Beso – Prince Royce
Mujer – Luis Fonsi
Reik – Me Niego ft. Ozuna
Reloj – Luis Miguel
Quédate Conmigo – Chyno Miranda ft. Wisin & Gente de Zona
Ella y Yo – Don Omar ft. Aventura
Mariposa Traicionera – Maná
Casi Te Envidio – Ricardo Arjona
Aló – Ricardo Montaner
Los Anillos – Jennifer Lopez
Baila Baila Baila – Enrique Iglesias
Te Amo – Franco de Vita
La Vida Es Bella – Ricky Martin
Qué Bonito – Manuel Turizo
Despacito (Remix) – Luis Fonsi, Daddy Yankee ft. Justin Bieber
Me Enamora – Juanes
En Mi Viejo San Juan – José Feliciano
Viva la Vida – Coldplay (Latin remix)
Veneno – Rubén Blades
Déjala Que Vuelva – Piso 21 ft. Manuel Turizo
Hoy – Gloria Estefan
Ángel – Luis Fonsi
Rumba – Anuel AA ft. Farruko
Te Amo – Franco de Vita
La Cumbia del Río – Los Ángeles Azules
Perdóname – Camilo Sesto
Si Te Vas – David Bisbal
No Lo Voy A Olvidar – Franco de Vita
Chao Bella – Bebe
Dile Que Tú Me Quieres – Ozuna
Todo de Ti – Rauw Alejandro
Amores Extraños – Ricardo Arjona
Me Enamora – Juanes
Mi Amor – Mon Laferte
Me Despierta – Ricardo Arjona
La Bicicleta – Carlos Vives & Shakira
Échame La Culpa – Luis Fonsi ft. Demi Lovato
La Vida Es Un Carnaval – Celia Cruz
El Amor – Tito El Bambino
Cásate Conmigo – Silvestre Dangond & Nicky Jam
La Gozadera – Gente de Zona ft. Marc Anthony
Baila Baila Baila – Enrique Iglesias
Baila Reggaeton – Zion & Lennox





