Blinding Lights - The Weeknd
Shape of You - Ed Sheeran
Uptown Funk - Mark Ronson ft. Bruno Mars
Rolling in the Deep - Adele
Bad Guy - Billie Eilish
Levitating - Dua Lipa
Dance Monkey - Tones and I
Someone Like You - Adele
Old Town Road - Lil Nas X ft. Billy Ray Cyrus
Watermelon Sugar - Harry Styles
Good 4 U - Olivia Rodrigo
Don't Start Now - Dua Lipa
Havana - Camila Cabello ft. Young Thug
Shallow - Lady Gaga & Bradley Cooper
Thank U, Next - Ariana Grande
Bad Romance - Lady Gaga
Happy - Pharrell Williams
Despacito - Luis Fonsi ft. Daddy Yankee
Call Me Maybe - Carly Rae Jepsen
All About That Bass - Meghan Trainor
Senorita - Shawn Mendes & Camila Cabello
Perfect - Ed Sheeran
Roar - Katy Perry
Sorry - Justin Bieber
Starboy - The Weeknd
Someone You Loved - Lewis Capaldi
Truth Hurts - Lizzo
Love Yourself - Justin Bieber
Counting Stars - OneRepublic
Rude - MAGIC!
Sucker - Jonas Brothers
Can't Stop the Feeling! - Justin Timberlake
I Don't Care - Ed Sheeran & Justin Bieber
Sour Candy - Lady Gaga & BLACKPINK
Midnight City - M83
Pillowtalk - Zayn
Hotline Bling - Drake
Stitches - Shawn Mendes
Toxic - Britney Spears
Tik Tok - Kesha
Umbrella - Rihanna ft. Jay-Z
Just Dance - Lady Gaga ft. Colby O'Donis
We Found Love - Rihanna ft. Calvin Harris
Bang Bang - Jessie J, Ariana Grande, Nicki Minaj
Firework - Katy Perry
The Middle - Zedd, Maren Morris, Grey
Radioactive - Imagine Dragons
I'm Still Standing - Elton John
Can't Feel My Face - The Weeknd
Diamonds - Rihanna
Grenade - Bruno Mars
Waka Waka (This Time for Africa) - Shakira
Just the Way You Are - Bruno Mars
Halo - Beyoncé
Stay - Zedd & Alessia Cara
No Tears Left to Cry - Ariana Grande
Rise - Katy Perry
Dusk Till Dawn - Zayn ft. Sia
Perfect Illusion - Lady Gaga
Sweetener - Ariana Grande
Break Free - Ariana Grande ft. Zedd
What Do You Mean? - Justin Bieber
Here - Alessia Cara
My Heart Will Go On - Celine Dion
Don't Let Me Down - The Chainsmokers ft. Daya
Hey Ya! - OutKast
Dynamite - BTS
I Gotta Feeling - The Black Eyed Peas
Hate Me - Ellie Goulding
I Kissed a Girl - Katy Perry
Dance Again - Jennifer Lopez ft. Pitbull
We Belong Together - Mariah Carey
Glad You Came - The Wanted
Gimme More - Britney Spears
We Can't Stop - Miley Cyrus
Call on Me - Eric Prydz
Kiss Me More - Doja Cat ft. SZA
Party in the U.S.A. - Miley Cyrus
I'm Still Standing - Elton John
SexyBack - Justin Timberlake
Lady - Little River Band
Breakaway - Kelly Clarkson
Oops!... I Did It Again - Britney Spears
Stronger (What Doesn't Kill You) - Kelly Clarkson
Boys Don’t Cry - The Cure
All of Me - John Legend
Can't Stop - Red Hot Chili Peppers
I’m Yours - Jason Mraz
Somebody That I Used to Know - Gotye ft. Kimbra
Sugar - Maroon 5
Taki Taki - DJ Snake ft. Selena Gomez, Ozuna, Cardi B
Applause - Lady Gaga
Let It Go - Idina Menzel
Chandelier - Sia
Starships - Nicki Minaj
Girls Like You - Maroon 5 ft. Cardi B
I Will Always Love You - Whitney Houston
Locked Out of Heaven - Bruno Mars
The Way - Ariana Grande ft. Mac Miller
I Love It - Icona Pop ft. Charli XCX







